
# This file is used to load in a map.


map 1 1 1 1 1 1 1 1 1 1 1 1 1
map 1 3 0 2 2 2 2 2 2 2 0 0 1
map 1 0 1 2 1 2 1 2 1 2 1 0 1
map 1 2 1 0 0 0 2 0 0 0 1 2 1
map 1 2 0 0 1 2 1 2 1 0 0 2 1
map 1 2 1 0 2 2 0 2 2 0 1 2 1
map 1 2 0 2 0 2 0 2 0 2 0 2 1
map 1 2 1 0 2 2 0 2 2 0 1 2 1
map 1 2 0 0 1 2 1 2 1 0 0 2 1
map 1 2 1 0 0 0 2 0 0 0 1 2 1
map 1 0 1 2 1 2 1 2 1 2 1 0 1
map 1 0 0 2 2 2 2 2 2 2 0 0 1
map 1 1 1 1 1 1 1 1 1 1 1 1 1
